11111111
10200001
10000001
10000001
10000p01
10000001
10300001
11111111